.@..#...$..#..$.
##..#......#..##
................
.....#..##......
####........####
.............#.$
..##.........#..
......####......
......####......
$##..........#..
................
####........####
.....##..#......
................
##..#......#..##
.$..#..$...#..$.