##############
#............#
#............#
#............#
#............#
#............#
#............#
#............#
#............#
#............#
#............#
#............#
#.@..........#
##############