.##....##.....$.
.@#..#.$#.#..##.
#.####.##.##.#..
#..#.$.#...#.#.#
##.#.#.##..#..$.
$#.#.###..##.##.
.....#.#.##..#..
####...#.#..$#..
$#.##.##.##.##.#
.#.#..$#....#..#
.#.###.###.##.##
...$#..#...#..$#
##.##.##..####..
#..#...#....#..#
..##.#....###..#
#.$..#......$.##