@..............$
.......$.....$..
...............$
....$......$....
$..............$
......$.........
...............$
...$............
..........$....$
..$...$.........
...............$
.$.......$......
...............$
$.....$....$....
...............$
.$.$.$.$.$.$.$..