.##...$....$....
.#..#........#.#
.#@.#.......$#..
...##..$.....###
....#.#####.....
$...#........##.
##.....$.....$..
......######..##
#.....$.....#..#
##..###..###..$.
.#..#.....$####.
...$.......#.#..
.#..#.#..###....
.#...........#..
.#....#...#..#..
.$.#..#......#$#