................
.@..............
###..........###
..............#.
................
................
................
................
................
................
................
................
.#..............
###..........###
..............#.
................