@..........$....
..............$.
....$...........
...........$....
....$..........$
...........$....
.$..............
..............$.
..$.....$.......
................
............$...
................
.....$...$......
................
.$...........$..
.......$.......$