....#......#....
.@............$.
....#......#....
...###....###...
................
................
................
................
####........####
................
.......$........
................
...#$.....$.#...
...#........#...
.$.####..####.$.
...#........#...