................
.@#.$#.$#.$#.$#.
..#..#..#..#..#.
..#..#..#..#..#.
..#..#..#..#..#.
..#..#..#..#..#.
................
...#.#.#.#.#.#..
...#.#.#.#.#.#..
................
..#..#..#..#..#.
..#..#..#..#..#.
..#..#..#..#..#.
..#..#..#..#..#.
..#$.#$.#$.#$.#.
................