...............$
.###############
...$............
###############.
.............$..
.###############
...$............
###############.
.............$..
.###############
..$.............
###############.
............$...
.###############
..$.............
###############@