.#.#.#.#.#.#.#.#
................
@#$#$#$#$#$#$#$#
.#.#.#.#.#.#.#.#
.#.#.#.#.#.#.#.#
.#.#.#.#.#.#.#.#
.#.#.#.#.#.#.#.#
.#.#.#.#.#.#.#.#
.#.#.#.#.#.#.#.#
.#.#.#.#.#.#.#.#
.#.#.#.#.#.#.#.#
.#.#.#.#.#.#.#.#
.#.#.#.#.#.#.#.#
$#$#$#$#$#$#$#$#
................
.#.#.#.#.#.#.#.#